 , , ,-, , , ,-, , , ,-,p1, , 
 , , ,-, , , ,-, , , ,-, , , 
 ,p2, ,-, , , ,-, , , ,-, , , 
-,-,-,-,-,-,-,-,-,-,-,-,-,-,-
 , , ,-, , , ,-, , , ,-, , , 
 , , ,-, , , ,-, , , ,-, , , 
 , , ,-, , , ,-, , , ,-, , , 
-,-,-,-,-,-,-,-,-,-,-,-,-,-,-
 , , ,-,p9,k9, ,-, , , ,-, , ,p9
 , , ,d5, , , ,l9, , , ,-, ,k10,x
 , , ,-,i, , ,-, , , ,-, , , 
-,-,-,-,d9,-,-,-,-,-,-,-,-,-,d10
 , , ,-, , , ,-, , , ,-, , , 
 , , ,-, , , ,-, , , ,-, , , 
 , , ,-, , , ,-, , , ,-, , , 
