 , , ,-, , , ,-,t7, ,k12,-, , , 
 , , ,-, , , ,-, , ,i,-, , , 
 , , ,-, , , ,-, , , ,-, , , 
-,-,-,-,-,-,-,-,-,d12,-,-,-,-,-
 , , ,-, , , ,-, , , ,-, , , 
 , , ,-,t1, , ,-, , , ,-, ,t7,k5
 , , ,-, , , ,-, , , ,-, ,x, 
-,-,-,-,-,-,-,-,-,-,d7,-,-,d5,-
 , , ,-, , , ,-, , , ,-, , , 
 , , ,-, , , ,-, , , ,-, , , 
 , , ,-, , , ,-, , , ,-, , , 
-,-,-,-,-,-,-,-,-,-,-,-,-,-,-
 , , ,-, , , ,-, , , ,-, , , 
 , , ,-, , , ,-, , , ,-, , , 
 , , ,-, ,t8, ,-, , , ,-, , , 
