 , , ,-, , , ,-, , , ,-, , , 
 , , ,-, , , ,-, , , ,-, , , 
 , , ,-, , , ,-, , , ,-, , , 
d6,-,-,-,-,-,-,-,-,-,-,-,-,-,-
 ,k8, ,-, , , ,-, , , ,-,i, ,t7
t7, , ,d8, , , ,-, , , ,-, , ,k2
 ,x, ,-, , , ,-, , , ,-, , , 
-,-,-,-,-,-,-,-,-,-,d9,-,-,d2,-
 , , ,-, , , ,-, , , ,-, , , 
 , , ,-, , , ,-, , , ,-, , , 
 , , ,-, , , ,-, , , ,-, , , 
-,-,-,-,-,-,-,-,-,-,-,-,-,-,-
 , , ,-, , , ,-, , , ,-, , , 
 , , ,-, , , ,-, , , ,-, , , 
 , , ,-, , , ,-, , , ,-, ,p8, 
