p3, , ,-, , , ,-, , , ,-, , , 
 , ,x,-, , , ,-, , , ,-, , , 
 ,p5, ,-, , , ,-, , , ,-, , , 
-,-,l3,-,-,-,-,-,-,-,-,-,-,-,-
 , , ,-, ,p1, ,-, , , ,-, , , 
 , , ,-, , , ,-,p3, , ,-, , , 
 , , ,-, , , ,-, , , ,-, ,t3, 
-,-,-,-,-,-,-,-,-,-,-,-,-,l9,-
 , , ,-, , , ,d10, , , ,-, , , 
 , , ,-, , , ,-, , , ,-,p5, ,p9
 , , ,-, , , ,-, , , ,-, , ,i
-,-,-,-,-,-,-,-,-,-,-,-,-,l5,-
 , , ,-, , , ,-, , , ,-, , , 
 , , ,-, , , ,-, , , ,-, , , 
 , ,p9,-, , , ,-, , , ,-, , , 
