 , , ,-, , , ,-, , , ,-, , , 
 , , ,-, , , ,-, , , ,-, , , 
 , , ,-, , , ,-, , , ,-,t4, , 
-,-,-,-,-,-,-,-,-,-,-,-,-,-,-
c12, , ,-, , , ,-, , , ,-, , , 
i, , ,-, , , ,-, , , ,-, , , 
c7,t7, ,-, , , ,-, ,c2, ,-, , , 
-,-,-,-,-,-,-,-,-,-,-,-,-,-,-
 , , ,-, , , ,-, , , ,-, , , 
x, , ,-, , , ,-, , , ,-, , , 
 ,c1, ,-, , , ,-, , , ,-, , , 
-,-,-,-,-,-,-,-,-,-,-,-,-,-,-
 , , ,-, , , ,-, , , ,-, , , 
 , , ,-, , , ,-, , , ,-, , , 
 , , ,-, , , ,-, , , ,-, , , 
