 , , ,-, , , ,-, , , ,-, , , 
 , , ,-, , , ,-, , , ,-, , , 
 , , ,-, , , ,-, , , ,-, , , 
-,-,-,-,-,-,-,-,-,-,-,-,-,-,-
 , , ,-, , , ,-, , , ,-, , , 
 , , ,d2, , , ,-, , , ,-, , , 
 , , ,-, , , ,-, , , ,-, , , 
-,-,-,-,-,-,-,-,-,-,-,-,-,-,-
 , , ,-, , , ,-, , , ,-, , , 
 , , ,-, , , ,-, , , ,-, , , 
 , , ,-, , , ,d11, , , ,-, , , 
d10,d6,-,-,-,d7,-,-,-,-,-,-,-,-,-
k6, ,k8,d8, , ,k7,-, , , ,-, , , 
 ,i, ,-, , , ,-, , , ,-, , , 
 , , ,-, , ,x,-, , , ,-, , , 
