 , , ,-, , , ,-, , , ,-, , , 
 , , ,-, , , ,-, , , ,-, , , 
 , , ,-, , , ,d3, , , ,-, , , 
-,-,-,-,-,-,-,-,d10,-,-,-,-,-,-
 , , ,-, , , ,-, , , ,-, , , 
 , , ,-, , , ,-, , , ,-, , , 
 , , ,-, , , ,-, , , ,-, , , 
-,-,-,-,-,-,-,-,-,-,-,-,-,-,-
 , , ,-, , , ,-, , , ,-, , , 
 , , ,-, , , ,-, , , ,-, , , 
 , , ,-, , , ,-, , , ,-, , , 
-,-,-,-,-,-,d8,-,-,-,-,-,-,-,-
 , , ,-, , ,k9,-,k2,x, ,-, , , 
 , , ,d1,k8, , ,d9, , , ,d2, , , 
 , , ,-,i, , ,-, , , ,-, , , 
