 , , ,-, , , ,-, , ,p2,-, , , 
 , , ,-, , , ,-, , ,t4,-, , , 
 , , ,-, , , ,-, , ,t1,l2, , , 
-,-,-,-,-,-,-,-,-,-,-,-,-,l3,-
 , , ,-,p3, , ,-, , , ,-, , ,t8
 , , ,-, , , ,-, , , ,-, , ,p3
p5, , ,-, , , ,-, , , ,-, , , 
-,-,-,-,-,-,-,-,-,-,-,-,-,d7,-
 ,t10, ,-, , , ,-, , , ,-, , , 
k4, , ,-, , , ,-, , , ,-, , , 
 , , ,-, , , ,-, , , ,-, ,p2, 
-,d4,-,-,-,-,-,-,-,-,-,-,-,-,-
 ,x, ,-,t8, , ,-, , , ,-, , , 
 , ,t4,-, , , ,-, , , ,-, , , 
 , , ,-,i, ,t10,-, , , ,-, , , 
