 , , ,d12, , ,c11,-, , , ,-, , , 
 ,i, ,-, , , ,-, , , ,-, , , 
 ,c12,k12,-, ,x, ,-, , , ,-, , , 
-,-,-,-,-,-,-,-,-,-,-,-,-,-,-
 , , ,-, , , ,-, , , ,-, , , 
 , , ,-, , ,t5,-, , , ,-, , , 
 , , ,-, , , ,-, , , ,-, , , 
-,-,-,-,-,-,-,-,-,-,-,-,-,-,-
 , , ,-, , , ,-, , , ,-, , , 
 , , ,-, , , ,-, , , ,-, , , 
 , , ,-, , , ,-, , , ,-, , , 
-,-,-,-,-,-,-,-,-,-,-,-,-,-,-
 , , ,-, , , ,-, , , ,d8, , , 
 , , ,-, , , ,-, , , ,-, , , 
 ,t2, ,-, , , ,-, , , ,-, , , 
