 , , ,-, , , ,d11, , , ,-,t12, , 
 , , ,-, , ,x,-, , , ,-, , ,i
 , , ,-, ,t12,k11,-, , , ,-, , ,k10
-,-,-,-,-,-,-,-,-,-,-,-,-,-,d10
 , , ,-, , , ,-, , , ,-, , , 
 , , ,-,t4, , ,-, , , ,-, , , 
 , , ,-, , , ,-, , , ,-, , , 
-,-,-,-,-,-,-,-,-,-,-,-,-,-,-
 , , ,-, , , ,-, , , ,-, , , 
 , , ,-, , , ,-, , , ,-, , , 
 , , ,-, , , ,-, , , ,-, , , 
-,-,-,-,-,-,-,-,-,-,-,-,-,-,-
 , , ,-, , , ,-, , , ,-, , , 
 , , ,-, , , ,d5,t2, , ,-, , , 
 , , ,-, , , ,-, , , ,-, , , 
