i, , ,-, , , ,-, , , ,-, , , 
 , ,c3,-, ,t6, ,-, , , ,-, , , 
c7, , ,-, , , ,-, , , ,-, , , 
-,-,-,-,-,-,-,-,-,-,-,-,-,-,-
 , ,x,-, , , ,-, , , ,-, , , 
 , , ,-, , , ,-, , ,c4,-, , , 
 ,c6, ,-, , , ,-, , , ,-, , , 
-,-,-,-,-,-,-,-,-,-,-,-,-,-,-
 , , ,-, , , ,-, , , ,-, , , 
 , , ,-, , , ,-, , , ,-, , , 
 , , ,-, , , ,-, , , ,-, , , 
-,-,-,-,-,-,-,-,-,-,-,-,-,-,-
 , , ,-, , , ,-, ,c8, ,-, , , 
 , , ,-, , , ,-, , , ,-, , , 
 , , ,-, , , ,-, , , ,-, , , 
